R 1000 800

NO ./textures/blue.xpm

SO ./textures/brown.xpm

WE ./textures/Red10.xpm

EA ./textures/Slime.xpm

S ./textures/barrel.xpm

F 0,0,0

C 128,128,128

        0011111111111111110111111
        0100000000110000001000001
        0010000011100000010000011
        1001000200000000002000001
111111111111000001110000000000001
100000000011000001110100111111111
10000000200000000000000000001
10000000000000000000000000001
10000001100000222200011000001
1000000110000003000011000001
10000000000000000000000000001
10000000300000000000000000301
10000000000000000000010000001
11110111110111011100010030001
11118111118111811101010010001
11000000110101011100010000001
100010000044444000000100S0001
10000000004444400300010000001
11000001110181111111111181111
11113111 11100000000000000011
11111111 11111111111111111111
